111111111111111111
1E1000100010001001
101010101010101C01
101C101010101C1001
1011101010101010C1
1000C00010001000P1
111111111111111111