111111111111111111
1E1000100010001001
101010101010101C01
101C101010101C1001
1011101010101010C1
1000C00010001000P1
111111011101111111
111111011101111111
101000000010001001
101010101010101C01
101C101010101C1001
1011101010101010C1
1000C0001000100001
111111101111111111
111111101111111111
101000100010001001
101010101010101C01
101C101010101C1001
1011101010101010C1
1000C0001000100001
111111011101111111
111111011101111111
101000000010001001
101010101010101C01
101C101010101C1001
1011101010101010C1
1000C0001000100001
111111011111111111
111111011101111111
101000000010001001
101010101010101C01
101C101010101C1001
1011101010101010C1
1000C0001000100001
111111111111111111
