111111111
1000000C1
100000001
100000001
1P0000001
111111111