111111111111111111
1010001000100011E1
101010101010101C11
1010101010101C1001
1010101010101010C1
1000000010001000P1
111111111111111111