111111111
1000000E1
10C000001
100000001
1P0P00001
111111111