111111111
1000001C1
10E000011
110000001
1P1000001
111111111