111111111
1000001C1
10E000001
100000001
1P00000X1
111111111