111111111111111111
1P10001000100010E1
101010101010101C0
1010101010101C1001
1010101010101010C1
100000001000100001
111111111111111111
